69
±±±±±±±±±
±   ±±   
±±±I±±±± 
±     ±F±
±±± ±   ±
±±±±±±±±±